#############################################
#...........................................#
#...........................................#
#...........................................#
#...........................................#
#...........................................#
#...........................................#
#...........................................#
#...........................................#
#...........................................#
#...........................................#
#...........................................#
#...........................................#
#...........................................#
#...........................................#
#...........................................#
#...........................................#
#...........................................#
#...........................................#
#...........................................#
#...........................................#
#...........................................#
#...........................................#
#...........................................#
#...........................................#
#...........................................#
#....................################.......#
#....................#              #.......#
#....................#              #.......#
#....................#              #.......#
#...................|#              #.......#
#..................-+#              #.......#
#...........########|#              #.......#
#........|#|#      #|#              #.......#
#########|#|#      #|#              #|#######
#       #|#|#      #|#              #|#     #
#########|#|########|################|#     #
#----+---+-+--------+----------------|#     #
#####|###|#|#########################|#     #
#   #|# #|#|#                       #|#     #
#   #|# #|#|#                       #|#     #
#   #|# #|#|#                       #|#     #
#   #|###+-+#########################|#######
#   #+-------------------------------+------#
#############################################

