#############################################
#+----                                      #
#|                                          #
#|                                          #
#|                                          #
#|                                          #
#                                           #
#                                           #
#                                           #
#                                           #
#                                           #
#                                           #
#                                           #
#                                           #
#                                           #
#                                           #
#                                           #
#                                           #
#                                           #
#                                           #
#                                           #
#                                           #
#                                           #
#                                           #
#                                           #
#                                           #
#                                           #
#                                           #
#                                           #
#                                           #
#                                           #
#                                           #
#                                           #
#                                           #
#                                           #
#                                           #
#                                           #
#                                           #
#                                           #
#                                           #
#                                           #
#                                           #
#                                           #
#                                           #
#############################################
