#############################################
#+--------+#       #|#                 #---+#
#|########|#       #|########          ####|#
#|########|#########+------+#             #|#
#+--------+-------+########|##########    #|#
#|########|#######|#      #+--------+#    #|#
#|#      #|#     #|#      ##########|######|#
#|#      #|#     #|#               #+------+#
#|########|#######|#               #|########
#+--------+-------+#      ##########|#      #
##########|#######|#      #+--------+#      #
#        #|#     #|#      #|##########      #
#        #|#     #|########|#               #
#        #|#     #+--------+#               #
#        #|#     #|########|#               #
#        #|#######|#      #|#               #
#        #+-------+########|###########     #
#        #|##########+-----+---------+#     #
#        #|#        #|###############|#######
##########|##########|#             #+------#
#-------+-+----+-----+#             #|#######
########|######|#######             #|#     #
#      #|#    #|#                   #|#     #
#      #|#    #|#                   #|#     #
#      #|#    #|#####################|#     #
#      #|#    #+----+------+---------+#     #
#      #|#    ######|######|#########|#     #
########|####      #|#    #|#       #|#     #
#+------+--+#      #|######|#       #|#     #
#|#########|#      #+------+#       #|#     #
#|####|####|########|########       #|#     #
#+----+----+--------+#              #|#     #
###########|########|#              #|#######
#--------+#|#      #|#              #+------#
#########|#|#      #|#              #|#######
#       #|#|#      #|#              #|#     #
#########|#|########|################|#     #
#----+---+-+--------+------+---------+#     #
#####|###|#|########|######|#########|#     #
#   #|# #|#|#      #+------+#       #|#     #
#   #|# #|#|#      ##########       #|#     #
#   #|# #|#|#                       #|#     #
#   #|###+-+#########################|#######
#   #+-------------------------------+------#
#############################################

