#############################################
#...........................................#
#...........................................#
#...........................................#
#...........................................#
#...........................................#
#...........................................#
#...........................................#
#...........................................#
#...........................................#
##########..................................#
#        #..................................#
#        #..................................#
#        #..................................#
#        #..................................#
#        #..................................#
#        #..................................#
#        #...........+......................#
#        #|..........|###############.......#
##########|..........|#             #+......#
#-------+-+----+-----+#             #|#######
########|######|#######             #|#     #
#......#|#    #|#                   #|#     #
#......#|#    #|#                   #|#     #
#......#|#    #|#####################|#     #
#......#|#    #+----+----------------+#     #
#......#|#    ######|################|#     #
########|####      #|#              #|#     #
#+------+--+#      #|#              #|#     #
#|#########|#      #|#              #|#     #
#|####|####|########|#              #|#     #
#+----+----+--------+#              #|#     #
###########|########|#              #|#######
#--------+#|#      #|#              #+------#
#########|#|#      #|#              #|#######
#       #|#|#      #|#              #|#     #
#########|#|########|################|#     #
#----+---+-+--------+----------------+#     #
#####|###|#|#########################|#     #
#   #|# #|#|#                       #|#     #
#   #|# #|#|#                       #|#     #
#   #|# #|#|#                       #|#     #
#   #|###+-+#########################|#######
#   #+-------------------------------+------#
#############################################

